W W W W W W W W W W W W W W W W W W W W W W W W W W W W W W W W W W W W W W
W S S S S S S S S W S S S S S S S S W W S S S S S S S S W S S S S S S S S W
W S W W S W W W W W W W W W S W W S W W S W W S W W W W W W W W W S W W S W
W S S S S S S S S S E E E E S S S S W W S S S S S S S S S S S S S S S S S W
W S W W S W S W W W W W S W S W W S W S S W W S W S W W W W W S W S W W S W
W W W W S W W W E W E W W W S W W W W S W W W S W W W E W E W W W S W W W W
W E E W S W S S S S S E E W S S S S S S S S S S W S S S S S S S S S W E E W
W W W W S W E W E W E W E W S W W W W W W W W S W E W E W E W E W S W W W W
W E E E S E E W S E S W E E S S S S S S S S S S E E W S E S W E E S E E E W
W W W W E W E W W W W W E W S W W W W W W W W S W E W W W W W E W S W W W W
W E E W E W S S S S S S S W S S S S S S S S S S W E S S S S E E W S W E E W
W W W W E W E W W W W W E W S W W W W W W W W S W E W W W W W E W S W W W W
W S S S E S S S S W S S S S S S S S W W S S S S S S S S W S S S S S S S S W
W S W W S W W W W W W W W W S W W S W W S W W S W W W W W W W W W S W W S W
W S S W S S S S S P S S S S S W S S W W S S W S S S S S P S S S S S W S S W
W W S W S W S W W W W W S W S W S W W W W S W S W S W W W W W S W S W S W W
W S S S S W S S S W S S S W S S S S W W S S S S W S S S W S S S W S S S S W
W S W W W W W W S W S W W W W W W S W W S W W W W W W S W S W W W S W W S W
W E S W S S S S S W W S S S S W W S W W S S W S S S S S W W S E S S W W S W
W S S W W S W W S W W S W W S S S S S S S S W W S W W S W W S W W S S S S W
W S S S S E S E S S S S W S S S S S W W S S S S S S S S S S S W E E E E S W
W W W W W W W W W W W W W W W W W W W W W W W W W W W W W W W W W W W W W W
